YEAR,MONTH,Labor Force,Employed,Unemployed,Unemployment Rate
1976,1,7658970,6872159,786811,10.3
1976,2,7656709,6871169,785540,10.3
1976,3,7657019,6874360,782659,10.2
1976,4,7664202,6884805,779397,10.2
1976,5,7675792,6896958,778834,10.1
1976,6,7688483,6907840,780643,10.2
1976,7,7696362,6912373,783989,10.2
1976,8,7697049,6910069,786980,10.2
1976,9,7691659,6903919,787740,10.2
1976,10,7684134,6897272,786862,10.2
1976,11,7678510,6893843,784667,10.2
1976,12,7677887,6896742,781145,10.2
1977,1,7684683,6907949,776734,10.1
1977,2,7696320,6927449,768871,10.0
1977,3,7707711,6951957,755754,9.8
1977,4,7716524,6977815,738709,9.6
1977,5,7722450,7001957,720493,9.3
1977,6,7726627,7022113,704514,9.1
1977,7,7731601,7039090,692511,9.0
1977,8,7740387,7055788,684599,8.8
1977,9,7751263,7072870,678393,8.8
1977,10,7759503,7088701,670802,8.6
1977,11,7764199,7103182,661017,8.5
1977,12,7766972,7116749,650223,8.4
1978,1,7770273,7131276,638997,8.2
1978,2,7776274,7147465,628809,8.1
1978,3,7786471,7165251,621220,8.0
1978,4,7800480,7184303,616177,7.9
1978,5,7817720,7204757,612963,7.8
1978,6,7835746,7226363,609383,7.8
1978,7,7852829,7248347,604482,7.7
1978,8,7869398,7270385,599013,7.6
1978,9,7887005,7294101,592904,7.5
1978,10,7907987,7321205,586782,7.4
1978,11,7930716,7349665,581051,7.3
1978,12,7950015,7374569,575446,7.2
1979,1,7962186,7392215,569971,7.2
1979,2,7967468,7402825,564643,7.1
1979,3,7968558,7408717,559841,7.0
1979,4,7969332,7412399,556933,7.0
1979,5,7973393,7416357,557036,7.0
1979,6,7982172,7421428,560744,7.0
1979,7,7995247,7428759,566488,7.1
1979,8,8010119,7437684,572435,7.1
1979,9,8024170,7446512,577658,7.2
1979,10,8033796,7454201,579595,7.2
1979,11,8035657,7458830,576827,7.2
1979,12,8030532,7458271,572261,7.1
1980,1,8019843,7450357,569486,7.1
1980,2,8005787,7434432,571355,7.1
1980,3,7991318,7412577,578741,7.2
1980,4,7977848,7388893,588955,7.4
1980,5,7966957,7368052,598905,7.5
1980,6,7961264,7355112,606152,7.6
1980,7,7959823,7350961,608862,7.6
1980,8,7960540,7354004,606536,7.6
1980,9,7963193,7361615,601578,7.6
1980,10,7968175,7369830,598345,7.5
1980,11,7977595,7378582,599013,7.5
1980,12,7992929,7390440,602489,7.5
1981,1,8012355,7404757,607598,7.6
1981,2,8030887,7418444,612443,7.6
1981,3,8043149,7429098,614051,7.6
1981,4,8045767,7434257,611510,7.6
1981,5,8037871,7432667,605204,7.5
1981,6,8022179,7425334,596845,7.4
1981,7,8004179,7413783,590396,7.4
1981,8,7989004,7400061,588943,7.4
1981,9,7979395,7386136,593259,7.4
1981,10,7977109,7374003,603106,7.6
1981,11,7979955,7362817,617138,7.7
1981,12,7985416,7352480,632936,7.9
1982,1,7992415,7345465,646950,8.1
1982,2,8000081,7342484,657597,8.2
1982,3,8006251,7341352,664899,8.3
1982,4,8009200,7339620,669580,8.4
1982,5,8007911,7334729,673182,8.4
1982,6,8002375,7324193,678182,8.5
1982,7,7995066,7308403,686663,8.6
1982,8,7988988,7289607,699381,8.8
1982,9,7986033,7270434,715599,9.0
1982,10,7986476,7253501,732975,9.2
1982,11,7990478,7241908,748570,9.4
1982,12,7994369,7235137,759232,9.5
1983,1,7996323,7232007,764316,9.6
1983,2,7998848,7235007,763841,9.5
1983,3,8005867,7246805,759062,9.5
1983,4,8021537,7269024,752513,9.4
1983,5,8044485,7299646,744839,9.3
1983,6,8069852,7334696,735156,9.1
1983,7,8092616,7370162,722454,8.9
1983,8,8106755,7399979,706776,8.7
1983,9,8108669,7419967,688702,8.5
1983,10,8099624,7430518,669106,8.3
1983,11,8084293,7434675,649618,8.0
1983,12,8070649,7438772,631877,7.8
1984,1,8064319,7448740,615579,7.6
1984,2,8066238,7464981,601257,7.5
1984,3,8075279,7484054,591225,7.3
1984,4,8087066,7501278,585788,7.2
1984,5,8099223,7514190,585033,7.2
1984,6,8108605,7521459,587146,7.2
1984,7,8112320,7523709,588611,7.3
1984,8,8113461,7525735,587726,7.2
1984,9,8115887,7532033,583854,7.2
1984,10,8121672,7544702,576970,7.1
1984,11,8132791,7564121,568670,7.0
1984,12,8148926,7587372,561554,6.9
1985,1,8166112,7608114,557998,6.8
1985,2,8179548,7621705,557843,6.8
1985,3,8185507,7627467,558040,6.8
1985,4,8250657,7694005,556652,6.7
1985,5,8281437,7727728,553709,6.7
1985,6,8300178,7750231,549947,6.6
1985,7,8318404,7771516,546888,6.6
1985,8,8338976,7795437,543539,6.5
1985,9,8360850,7820905,539945,6.5
1985,10,8381270,7843211,538059,6.4
1985,11,8396228,7857703,538525,6.4
1985,12,8404000,7862496,541504,6.4
1986,1,8407317,7860804,546513,6.5
1986,2,8410923,7858631,552292,6.6
1986,3,8416566,7859591,556975,6.6
1986,4,8424189,7865801,558388,6.6
1986,5,8431816,7877404,554412,6.6
1986,6,8437555,7892708,544847,6.5
1986,7,8440030,7909184,530846,6.3
1986,8,8438876,7923797,515079,6.1
1986,9,8435265,7935441,499824,5.9
1986,10,8431745,7946109,485636,5.8
1986,11,8430015,7957039,472976,5.6
1986,12,8431729,7970654,461075,5.5
1987,1,8436752,7987333,449419,5.3
1987,2,8443338,8005336,438002,5.2
1987,3,8452127,8024923,427204,5.1
1987,4,8461776,8044668,417108,4.9
1987,5,8470031,8062016,408015,4.8
1987,6,8477703,8076402,401301,4.7
1987,7,8486728,8088999,397729,4.7
1987,8,8497626,8100997,396629,4.7
1987,9,8509116,8113516,395600,4.6
1987,10,8519019,8126244,392775,4.6
1987,11,8525763,8139188,386575,4.5
1987,12,8527225,8150169,377056,4.4
1988,1,8522477,8157405,365072,4.3
1988,2,8513985,8161262,352723,4.1
1988,3,8505714,8162351,343363,4.0
1988,4,8502963,8163183,339780,4.0
1988,5,8509303,8166770,342533,4.0
1988,6,8523291,8173862,349429,4.1
1988,7,8541837,8183813,358024,4.2
1988,8,8562348,8195330,367018,4.3
1988,9,8582323,8206697,375626,4.4
1988,10,8598269,8216318,381951,4.4
1988,11,8609413,8223746,385667,4.5
1988,12,8617608,8229591,388017,4.5
1989,1,8625311,8234904,390407,4.5
1989,2,8633416,8239330,394086,4.6
1989,3,8642072,8243436,398636,4.6
1989,4,8649910,8246296,403614,4.7
1989,5,8656355,8247234,409121,4.7
1989,6,8663022,8247120,415902,4.8
1989,7,8671116,8246965,424151,4.9
1989,8,8682239,8249635,432604,5.0
1989,9,8699034,8258751,440283,5.1
1989,10,8723445,8276613,446832,5.1
1989,11,8752808,8301180,451628,5.2
1989,12,8782742,8328628,454114,5.2
1990,1,8809538,8355512,454026,5.2
1990,2,8830158,8378789,451369,5.1
1990,3,8843802,8396155,447647,5.1
1990,4,8852412,8407481,444931,5.0
1990,5,8859219,8414252,444967,5.0
1990,6,8864926,8416361,448565,5.1
1990,7,8854042,8398147,455895,5.1
1990,8,8842225,8375109,467116,5.3
1990,9,8827378,8345814,481564,5.5
1990,10,8809893,8310905,498988,5.7
1990,11,8792538,8273763,518775,5.9
1990,12,8777521,8236980,540541,6.2
1991,1,8773727,8209122,564605,6.4
1991,2,8758006,8168428,589578,6.7
1991,3,8766508,8153993,612515,7.0
1991,4,8771073,8140451,630622,7.2
1991,5,8770127,8127978,642149,7.3
1991,6,8764102,8116914,647188,7.4
1991,7,8753769,8105713,648056,7.4
1991,8,8741406,8092762,648644,7.4
1991,9,8729813,8076760,653053,7.5
1991,10,8719869,8056199,663670,7.6
1991,11,8712428,8032894,679534,7.8
1991,12,8707458,8010067,697391,8.0
1992,1,8706178,7991644,714534,8.2
1992,2,8709813,7979433,730380,8.4
1992,3,8719632,7975334,744298,8.5
1992,4,8735103,7978590,756513,8.7
1992,5,8750871,7983836,767035,8.8
1992,6,8762742,7987488,775254,8.8
1992,7,8770278,7989659,780619,8.9
1992,8,8773672,7991445,782227,8.9
1992,9,8773887,7994081,779806,8.9
1992,10,8772922,7999640,773282,8.8
1992,11,8770480,8006960,763520,8.7
1992,12,8766588,8014958,751630,8.6
1993,1,8762058,8023792,738266,8.4
1993,2,8756783,8032552,724231,8.3
1993,3,8751392,8040290,711102,8.1
1993,4,8745154,8045683,699471,8.0
1993,5,8738912,8048317,690595,7.9
1993,6,8734009,8048434,685575,7.8
1993,7,8728275,8045221,683054,7.8
1993,8,8721868,8040565,681303,7.8
1993,9,8717155,8038014,679141,7.8
1993,10,8715402,8038806,676596,7.8
1993,11,8716941,8042306,674635,7.7
1993,12,8719570,8047617,671953,7.7
1994,1,8719039,8052875,666164,7.6
1994,2,8712773,8056402,656371,7.5
1994,3,8701585,8057665,643920,7.4
1994,4,8688145,8057850,630295,7.3
1994,5,8676273,8059574,616699,7.1
1994,6,8668851,8064618,604233,7.0
1994,7,8667957,8074627,593330,6.8
1994,8,8672077,8088625,583452,6.7
1994,9,8677501,8103949,573552,6.6
1994,10,8681113,8119010,562103,6.5
1994,11,8682369,8132577,549792,6.3
1994,12,8681361,8141526,539835,6.2
1995,1,8677366,8142602,534764,6.2
1995,2,8671425,8137136,534289,6.2
1995,3,8665281,8127898,537383,6.2
1995,4,8660916,8117854,543062,6.3
1995,5,8659978,8110330,549648,6.3
1995,6,8661964,8107121,554843,6.4
1995,7,8666019,8107846,558173,6.4
1995,8,8670255,8110637,559618,6.5
1995,9,8672475,8113828,558647,6.4
1995,10,8672136,8116152,555984,6.4
1995,11,8670536,8118468,552068,6.4
1995,12,8671789,8123272,548517,6.3
1996,1,8680061,8132910,547151,6.3
1996,2,8695968,8147151,548817,6.3
1996,3,8717412,8165220,552192,6.3
1996,4,8741196,8186775,554421,6.3
1996,5,8764348,8210941,553407,6.3
1996,6,8785657,8236441,549216,6.3
1996,7,8805219,8261837,543382,6.2
1996,8,8824631,8285611,539020,6.1
1996,9,8844615,8305179,539436,6.1
1996,10,8865107,8319379,545728,6.2
1996,11,8885637,8329339,556298,6.3
1996,12,8906168,8338342,567826,6.4
1997,1,8927761,8349931,577830,6.5
1997,2,8951227,8366322,584905,6.5
1997,3,8976127,8387881,588246,6.6
1997,4,9002152,8412593,589559,6.5
1997,5,9026376,8436246,590130,6.5
1997,6,9045582,8456031,589551,6.5
1997,7,9058479,8471720,586759,6.5
1997,8,9065324,8483806,581518,6.4
1997,9,9067857,8493892,573965,6.3
1997,10,9068585,8502827,565758,6.2
1997,11,9068172,8510271,557901,6.2
1997,12,9067062,8516593,550469,6.1
1998,1,9065416,8522656,542760,6.0
1998,2,9063924,8529559,534365,5.9
1998,3,9062144,8536797,525347,5.8
1998,4,9060216,8544599,515617,5.7
1998,5,9059821,8553281,506540,5.6
1998,6,9062760,8562593,500167,5.5
1998,7,9069095,8571754,497341,5.5
1998,8,9077460,8580999,496461,5.5
1998,9,9086383,8590251,496132,5.5
1998,10,9093778,8599246,494532,5.4
1998,11,9097877,8606606,491271,5.4
1998,12,9097840,8610676,487164,5.4
1999,1,9094074,8611289,482785,5.3
1999,2,9089825,8610048,479777,5.3
1999,3,9088999,8610106,478893,5.3
1999,4,9093451,8613345,480106,5.3
1999,5,9102479,8620236,482243,5.3
1999,6,9114041,8630426,483615,5.3
1999,7,9124845,8642160,482685,5.3
1999,8,9132508,8654051,478457,5.2
1999,9,9136158,8665640,470518,5.2
1999,10,9137212,8677224,459988,5.0
1999,11,9139593,8690839,448754,4.9
1999,12,9145231,8706579,438652,4.8
2000,1,9153721,8722626,431095,4.7
2000,2,9161373,8735957,425416,4.6
2000,3,9164960,8743376,421584,4.6
2000,4,9162783,8743469,419314,4.6
2000,5,9154327,8736957,417370,4.6
2000,6,9141115,8725743,415372,4.5
2000,7,9127546,8714462,413084,4.5
2000,8,9118922,8708689,410233,4.5
2000,9,9117064,8710620,406444,4.5
2000,10,9120777,8719377,401400,4.4
2000,11,9126380,8730589,395791,4.3
2000,12,9129982,8739200,390782,4.3
2001,1,9128039,8740605,387434,4.2
2001,2,9120132,8733557,386575,4.2
2001,3,9108245,8719823,388422,4.3
2001,4,9095320,8701872,393448,4.3
2001,5,9087010,8684335,402675,4.4
2001,6,9087123,8670637,416486,4.6
2001,7,9096796,8661781,435015,4.8
2001,8,9113151,8655226,457925,5.0
2001,9,9133898,8650292,483606,5.3
2001,10,9157095,8647326,509769,5.6
2001,11,9180165,8646147,534018,5.8
2001,12,9202819,8648361,554458,6.0
2002,1,9225509,8655523,569986,6.2
2002,2,9246806,8666443,580363,6.3
2002,3,9265302,8679350,585952,6.3
2002,4,9281975,8695207,586768,6.3
2002,5,9297067,8713553,583514,6.3
2002,6,9309180,8731635,577545,6.2
2002,7,9316834,8745647,571187,6.1
2002,8,9320911,8753883,567028,6.1
2002,9,9323265,8756201,567064,6.1
2002,10,9323293,8752564,570729,6.1
2002,11,9321908,8745900,576008,6.2
2002,12,9318783,8737938,580845,6.2
2003,1,9315785,8730879,584906,6.3
2003,2,9314431,8726174,588257,6.3
2003,3,9312793,8721904,590889,6.3
2003,4,9307352,8713651,593701,6.4
2003,5,9296497,8699109,597388,6.4
2003,6,9283664,8682191,601473,6.5
2003,7,9271586,8667803,603783,6.5
2003,8,9261573,8658414,603159,6.5
2003,9,9254717,8655456,599261,6.5
2003,10,9253604,8659302,594302,6.4
2003,11,9259003,8668362,590641,6.4
2003,12,9267759,8679731,588028,6.3
2004,1,9275669,8690232,585437,6.3
2004,2,9281530,8699403,582127,6.3
2004,3,9304365,8726537,577828,6.2
2004,4,9325796,8754380,571416,6.1
2004,5,9345424,8782986,562438,6.0
2004,6,9362431,8811495,550936,5.9
2004,7,9377918,8839205,538713,5.7
2004,8,9391690,8864589,527101,5.6
2004,9,9401360,8884406,516954,5.5
2004,10,9404648,8896900,507748,5.4
2004,11,9401294,8903284,498010,5.3
2004,12,9396977,8907852,489125,5.2
2005,1,9395352,8913873,481479,5.1
2005,2,9397267,8922290,474977,5.1
2005,3,9402641,8933249,469392,5.0
2005,4,9413319,8948092,465227,4.9
2005,5,9430767,8967742,463025,4.9
2005,6,9451917,8988295,463622,4.9
2005,7,9471800,9004782,467018,4.9
2005,8,9487602,9017089,470513,5.0
2005,9,9499119,9027253,471866,5.0
2005,10,9507494,9037183,470311,4.9
2005,11,9513815,9046842,466973,4.9
2005,12,9518216,9056031,462185,4.9
2006,1,9522997,9066533,456464,4.8
2006,2,9529175,9077960,451215,4.7
2006,3,9535839,9087985,447854,4.7
2006,4,9539977,9093660,446317,4.7
2006,5,9538316,9093999,444317,4.7
2006,6,9530898,9090653,440245,4.6
2006,7,9520777,9087715,433062,4.5
2006,8,9511488,9086770,424718,4.5
2006,9,9505259,9087981,417278,4.4
2006,10,9502793,9092269,410524,4.3
2006,11,9503075,9098570,404505,4.3
2006,12,9502870,9102977,399893,4.2
2007,1,9499799,9102241,397558,4.2
2007,2,9494831,9096946,397885,4.2
2007,3,9488991,9088533,400458,4.2
2007,4,9484728,9079753,404975,4.3
2007,5,9484366,9073042,411324,4.3
2007,6,9488494,9070029,418465,4.4
2007,7,9497120,9071651,425469,4.5
2007,8,9509680,9077545,432135,4.5
2007,9,9525259,9087657,437602,4.6
2007,10,9541506,9099049,442457,4.6
2007,11,9556141,9109703,446438,4.7
2007,12,9568190,9118591,449599,4.7
2008,1,9577044,9124073,452971,4.7
2008,2,9583530,9126805,456725,4.8
2008,3,9590062,9128290,461772,4.8
2008,4,9599018,9129190,469828,4.9
2008,5,9612247,9130656,481591,5.0
2008,6,9630028,9133515,496513,5.2
2008,7,9649719,9136086,513633,5.3
2008,8,9668018,9135938,532080,5.5
2008,9,9682451,9129223,553228,5.7
2008,10,9693575,9114128,579447,6.0
2008,11,9703038,9091347,611691,6.3
2008,12,9711658,9062948,648710,6.7
2009,1,9719617,9031621,687996,7.1
2009,2,9727756,9000993,726763,7.5
2009,3,9657401,8896423,760978,7.9
2009,4,9666899,8879394,787505,8.1
2009,5,9672903,8866030,806873,8.3
2009,6,9673753,8852531,821222,8.5
2009,7,9668943,8836214,832729,8.6
2009,8,9659298,8816461,842837,8.7
2009,9,9647854,8796265,851589,8.8
2009,10,9636718,8778512,858206,8.9
2009,11,9630492,8767080,863412,9.0
2009,12,9633209,8765800,867409,9.0
2010,1,9644070,8775340,868730,9.0
2010,2,9657047,8790529,866518,9.0
2010,3,9666303,8804772,861531,8.9
2010,4,9669447,8814800,854647,8.8
2010,5,9665480,8819490,845990,8.8
2010,6,9654362,8817095,837267,8.7
2010,7,9638270,8807520,830750,8.6
2010,8,9621243,8794278,826965,8.6
2010,9,9605787,8780710,825077,8.6
2010,10,9593183,8770596,822587,8.6
2010,11,9581746,8764573,817173,8.5
2010,12,9570220,8761434,808786,8.5
2011,1,9559651,8760232,799419,8.4
2011,2,9548708,8757912,790796,8.3
2011,3,9536257,8752207,784050,8.2
2011,4,9523346,8742652,780694,8.2
2011,5,9513763,8731832,781931,8.2
2011,6,9510326,8723753,786573,8.3
2011,7,9514587,8722045,792542,8.3
2011,8,9524566,8725968,798598,8.4
2011,9,9536393,8732476,803917,8.4
2011,10,9548032,8739046,808986,8.5
2011,11,9556997,8743315,813682,8.5
2011,12,9561987,8744223,817764,8.6
2012,1,9564435,8742699,821736,8.6
2012,2,9568747,8742066,826681,8.6
2012,3,9575456,8742131,833325,8.7
2012,4,9581857,8742019,839838,8.8
2012,5,9588258,8744437,843821,8.8
2012,6,9595186,8751630,843556,8.8
2012,7,9602750,8764316,838434,8.7
2012,8,9612652,8781926,830726,8.6
2012,9,9625882,8802411,823471,8.6
2012,10,9638067,8820734,817333,8.5
2012,11,9645668,8833612,812056,8.4
2012,12,9647282,8840572,806710,8.4
2013,1,9643243,8842773,800470,8.3
2013,2,9637148,8844420,792728,8.2
2013,3,9634141,8850795,783346,8.1
2013,4,9638121,8864330,773791,8.0
2013,5,9646461,8880236,766225,7.9
2013,6,9655330,8893914,761416,7.9
2013,7,9660293,8902869,757424,7.8
2013,8,9655577,8906160,749417,7.8
2013,9,9640261,8905146,735115,7.6
2013,10,9620358,8902906,717452,7.5
2013,11,9601154,8901935,699219,7.3
2013,12,9583747,8901999,681748,7.1
2014,1,9568507,8903251,665256,7.0
2014,2,9555038,8905204,649834,6.8
2014,3,9543233,8906972,636261,6.7
2014,4,9531922,8907932,623990,6.5
2014,5,9521136,8909964,611172,6.4
2014,6,9512596,8914743,597853,6.3
2014,7,9506832,8921190,585642,6.2
2014,8,9505320,8929372,575948,6.1
2014,9,9507458,8938865,568593,6.0
2014,10,9510169,8948744,561425,5.9
2014,11,9512399,8958578,553821,5.8
2014,12,9517113,8969792,547321,5.8
2015,1,9524954,8982601,542353,5.7
2015,2,9533927,8995441,538486,5.6
2015,3,9542416,9008594,533822,5.6
2015,4,9548293,9021384,526909,5.5
2015,5,9549164,9032002,517162,5.4
2015,6,9543550,9038865,504685,5.3
2015,7,9534767,9043435,491332,5.2
2015,8,9527129,9047482,479647,5.0
2015,9,9523717,9053257,470460,4.9
2015,10,9527500,9062751,464749,4.9
2015,11,9537575,9074704,462871,4.9
2015,12,9548386,9085645,462741,4.8
2016,1,9554664,9092379,462285,4.8
2016,2,9553707,9092674,461033,4.8
2016,3,9545384,9086193,459191,4.8
2016,4,9533668,9075462,458206,4.8
2016,5,9523916,9064157,459759,4.8
2016,6,9518429,9054675,463754,4.9
2016,7,9516807,9048360,468447,4.9
2016,8,9517447,9045264,472183,5.0
2016,9,9518718,9044383,474335,5.0
2016,10,9518573,9045425,473148,5.0
2016,11,9517508,9050218,467290,4.9
2016,12,9518132,9059508,458624,4.8
2017,1,9786877,9326683,460194,4.7
2017,2,9800351,9346626,453725,4.6
2017,3,9817572,9366666,450906,4.6
2017,4,9835869,9384093,451776,4.6
2017,5,9852683,9398001,454682,4.6
2017,6,9865598,9407322,458276,4.6
2017,7,9872094,9410601,461493,4.7
2017,8,9870248,9407451,462797,4.7
2017,9,9860903,9399265,461638,4.7
2017,10,9846668,9388484,458184,4.7
2017,11,9830847,9377414,453433,4.6
2017,12,9817592,9370967,446625,4.5
2018,1,9802719,9361939,440780,4.5
2018,2,9803973,9372373,431600,4.4
2018,3,9812713,9391095,421618,4.3
2018,4,9823257,9412158,411099,4.2
2018,5,9829787,9428753,401034,4.1
2018,6,9830937,9438572,392365,4.0
2018,7,9828624,9442483,386141,3.9
2018,8,9827008,9443161,383847,3.9
2018,9,9827558,9441924,385634,3.9
2018,10,9830666,9441120,389546,4.0
2018,11,9835681,9442909,392772,4.0
2018,12,9840825,9447272,393553,4.0
2019,1,9843200,9452089,391111,4.0
2019,2,9840991,9456144,384847,3.9
2019,3,9835870,9458865,377005,3.8
2019,4,9831378,9461587,369791,3.8
2019,5,9830577,9464972,365605,3.7
2019,6,9834810,9468743,366067,3.7
2019,7,9842925,9472035,370890,3.8
2019,8,9853617,9475946,377671,3.8
2019,9,9868458,9486126,382332,3.9
2019,10,9886761,9500903,385858,3.9
2019,11,9904428,9514584,389844,3.9
2019,12,9913846,9519010,394836,4.0
2020,1,9909100,9508711,400389,4.0
2020,2,9888746,9482072,406674,4.1
2020,3,9857996,9446108,411888,4.2
2020,4,9140152,7711204,1428948,15.6
2020,5,9434270,7864597,1569673,16.6
2020,6,9525690,8235435,1290255,13.5
2020,7,9566448,8371925,1194523,12.5
2020,8,9506207,8478569,1027638,10.8
2020,9,9539035,8571168,967867,10.1
2020,10,9505536,8628753,876783,9.2
2020,11,9522787,8670558,852229,8.9
2020,12,9526609,8697410,829199,8.7
2021,1,9529706,8719038,810668,8.5
2021,2,9536568,8743816,792752,8.3
2021,3,9541206,8776986,764220,8.0
2021,4,9558780,8814695,744085,7.8
2021,5,9558574,8852224,706350,7.4
2021,6,9590039,8885116,704923,7.4
2021,7,9576306,8909301,667005,7.0
2021,8,9577488,8932320,645168,6.7
2021,9,9553876,8956839,597037,6.2
2021,10,9557783,8989806,567977,5.9
2021,11,9562350,9026895,535455,5.6
2021,12,9587317,9067724,519593,5.4
2022,1,9602911,9109926,492985,5.1
2022,2,9607227,9151475,455752,4.7
2022,3,9611138,9186959,424179,4.4
2022,4,9625656,9216267,409389,4.3
2022,5,9633295,9234958,398337,4.1
2022,6,9634076,9243670,390406,4.1
2022,7,9621185,9240249,380936,4.0
2022,8,9599565,9229179,370386,3.9
2022,9,9605907,9217893,388014,4.0
2022,10,9612141,9213145,398996,4.2
2022,11,9618640,9220195,398445,4.1
2022,12,9626379,9230918,395461,4.1
2023,1,9632060,9229490,402570,4.2
2023,2,9646609,9245321,401288,4.2
2023,3,9659921,9268326,391595,4.1
2023,4,9676461,9291578,384883,4.0
2023,5,9703853,9321352,382501,3.9
